R 1920 1080
NO ./assets/blue.xpm
SO ./assets/brick.xpm
WE ./assets/wood.xpm
EA ./assets/grey.xpm
S ./assets/barrel.xpm
F 0,165,79
C 255,165,79

                       11111
1111111111111111111111110001
1000000000000000000000001001
1000000000000000000000001001
1000001111000000000000001001
1000001  1000000000000001001
1111111  1000000000000001001
         1111111111100001001
1111111111111111111100001001
1000000001         100001001
10S0000001         1000010011111
1000000001         1000010001111
10000000011111111111000010000001111111111111111111111111
1000000000000000000000001110000000000000000000000000000111111111111111
1000000000000000000000000011100000000000000000000000001000000000000001
1000000000000000000000000000111000000000000000000000001000000000000001
1000000000000000000000000000001110000000000000000000001000000000000001
1000000000000000000000000000000011100000000000000000001000000000000001
1000000000000000000111000000000000111000000000000000001000000000000001
1000000000000000000001110000000000001110000000000000001000000000000001
1000000000000000000000011100000000000011100000000000001000000000000001
1000000000000000000000000111000000000000111111111111111000000000000001
1000000000000000000000000001110000000000000000000000000000000000000001
1000000000000000000000000000011100000000000000000000000000000000000001
1000000000000000000000000000000111000000000000000000000000000000000001
1000000000000000000000000000000001110000000011111111111000000000000001
1000000000000000000000000000000000001000000012000000000000000000000001
1000000000000000000000000000000000001000000012000000000000000000000001
1222222220000000000000000000000000011000000012000000000000000000000001
1000000000000000000000000000000000001000000012000000000000000000000001
1111111111111111111111111111111111111111111111111111111111111111111111
