R 1920 1080
NO ./assets/blue.xpm
SO ./assets/brick.xpm
WE ./assets/wood.xpm
EA ./assets/grey.xpm
S ./assets/barrel.xpm
F 0,165,79
C 255,165,79

11111111111111111111111111111111111111111
10002000000000200000E00000200000000020001
11111111111111111111111111111111111111111