R 1920 1080
NO ./assets/blue.xpm
SO ./assets/brick.xpm
WE ./assets/wood.xpm
EA ./assets/grey.xpm
S ./assets/barrel.xpm
F 0,0,255
C 225,0,0

11111
10001
10N01
10001
11111