R 1920 1080
NO ./assets/blue.xpm
SO ./assets/brick.xpm
WE ./assets/wood.xpm
EA ./assets/grey.xpm
S ./assets/chalice.xpm
F 0,0,255
C 255,0,0

11111111111
100000000021
100000000021
100200N00021
100200000021
100200000021
100200000021
11111111111
