R 1920 1080
NO ./path_to_the_north_texture
SO ./path_to_the_south_texture
WE ./path_to_the_west_texture
EA ./path_to_the_east_texture
S ./path_to_the_sprite_texture
F 220,100,0
C 225,30,0

1111111111111111111111111
1000000000110000000000001
1011000001110000002000001
100100000000000000100000111111111
111111111011000001110000000000001
10000000001100000111011111111111
11110111111111011100000010001
1111011111111101010100100011
11000000110101011100000010001
10002000000000001100000010001
10000000000000001101010010001
11000001110101011111011110N0111
11110001 1010101 11111010001
11111111 1111111 111111111111