R 10000 10000
NO ./assets/blue.xpm
SO ./assets/brick.xpm
WE ./assets/wood.xpm
EA ./assets/grey.xpm
S ./assets/hitler.xpm
F 255,165,79
C 12,183,242

111111111111
100000000001
100000000001
102000W00001
101000000001
100000000001
1000000000011111
11111111111000001
          1000001
          1000001
          1111111
