R 1920 1080
NO ./assets/blue.xpm
SO ./assets/brick.xpm
WE ./assets/wood.xpm
EA ./assets/grey.xpm
S ./assets/barrel.xpm
F 0,0,255
C 255,0,0

11111111111
100000000001
100000000001
102000N00001
100000000001
100000000001
100000000001
11111111111
