R 1920 1080
NO ./assets/blue.xpm
SO ./assets/brick.xpm
WE ./assets/wood.xpm
EA ./assets/grey.xpm
S ./assets/barrel.xpm
F 0,0,255
C 225,0,0

111111111111111111111111
100000000000000000000001
100000000000000000000001
100000000000000000000001
100002000000000000000001
100002200000000000000001
100000000000000000000001
10000000000N000000000001
100000000011000000000001
100000000000000000000001
100000000000000000000001
100000000000000000000001
100000000000000000000001
100000000000000000000001
100000000000000000000001
111111111111111111111111